Airbag двери	Airbag / Безопасность
Airbag коленей	Airbag / Безопасность
Airbag руля	Airbag / Безопасность
Airbag сидения	Airbag / Безопасность
Airbag торпеды	Airbag / Безопасность
Airbag шторка	Airbag / Безопасность
CD-changer	Электрика
DVD плеер	Электрика
GPS трекер	Электрика
Manual инструкция	Аксессуары
OBD Разьем	Электрика
Usb switch connector	Электрика
Webasto	Отопление и кондиционирование
Абсорбер (наполнитель) бампера	Кузов и элементы
Абсорбер топливный	Топливная система
Адаптер дроссельной заслонки	Кронштейны двигателя
Аккумулятор	Электрика
АКПП	Трансмиссия
Актуатор сцепления	Трансмиссия
Актуатор турбины	Впускная система
Амортизатор	Подвеска
Амортизатор багажника	Кузов и элементы
Амортизатор бардачка	Салон
Амортизатор в сборе	Подвеска
Амортизатор капота	Кузов и элементы
Амортизатор стекла крышки багажника	Кузов и элементы
Антенна	Электрика
Антенна Bluetooth	Электрика
Антенна GPS	Электрика
Антенна бесключевого доступа	Электрика
Антенна иммобилайзера	Электрика
Антенна телефона	Электрика
Антифриз	Система охлаждения
Аптечка	Аксессуары
Ароматизатор	Аксессуары
Байпасный клапан	Двигатель и элементы
Балансирный вал	Двигатель и элементы
Балка подвески	Подвеска
Балонный ключ	Аксессуары
Бампер	Наружные элементы кузова
Барабан Акпп	Трансмиссия
Бардачок	Салон
Бардачок водительский	Салон
Бардачок с разъёмом подключения IPod	Салон
Бардачок сидения	Салон
Бардачок торпеды	Салон
Бардачок центральной консоли	Салон
Батарея высоковольтная	Электрика
Бачок гидроусилителя	Рулевое управление
Бачок омывателя	Кузов и элементы
Бачок расширительный	Система охлаждения
Бачок тормозной жидкости	Тормозная система
Блок abs	Тормозная система
Блок Bluetooth	Электрика / Блоки управления
Блок FEM	Электрика / Блоки управления
Блок FRM	Электрика / Блоки управления
Блок Gateway	Электрика / Блоки управления
Блок TMS	Электрика / Блоки управления
Блок аварийного вызова	Электрика / Блоки управления
Блок асистента смены полосы движения	Электрика / Блоки управления
Блок балансирных валов	Двигатель и элементы
Блок бесключевого доступа	Электрика / Блоки управления
Блок зарядки	Электрика / Блоки управления
Блок инвертора	Электрика / Блоки управления
Блок клапанов подвески	Электрика / Блоки управления
Блок клапанов сидения	Электрика / Блоки управления
Блок кнопок	Электрика / Кнопки
Блок кнопок мультимедиа	Электрика / Блоки управления
Блок кнопок плафона салонного	Электрика
Блок кнопок стеклоподъемников	Электрика / Кнопки
Блок комфорта	Электрика / Блоки управления
Блок контроля Акб	Электрика / Блоки управления
Блок контроля температуры	Электрика / Блоки управления
Блок мультимедиа Dice	Электрика / Блоки управления
Блок навигации	Электрика / Блоки управления
Блок памяти сидений	Электрика / Блоки управления
Блок подачи ремня	Электрика / Блоки управления
Блок подкачки спинки сиденья	Электрика / Блоки управления
Блок подогрева руля	Электрика / Блоки управления
Блок подогрева системы охлаждения	Электрика / Блоки управления
Блок подрулевых переключателей	Электрика
Блок предохранителей	Электрика
Блок радиоприемника	Электрика / Блоки управления
блок регулировки сидения	Электрика / Кнопки
Блок реле	Электрика
Блок реле автон.сист.отопления/вентиляции	Электрика / Блоки управления
Блок розжига	Электрика
Блок сигнализации	Электрика / Блоки управления
Блок системы ввода голосовых сообщений	Электрика / Блоки управления
Блок системы диагностики	Электрика / Блоки управления
Блок системы отопления	Электрика / Блоки управления
Блок системы подавления вибрации	Электрика / Блоки управления
Блок телематики	Электрика / Блоки управления
Блок управления	Электрика / Блоки управления
Блок управления abs	Электрика / Блоки управления
Блок управления airbag	Airbag / Безопасность
Блок управления CAS	Электрика / Блоки управления
Блок управления Controller Touch	Электрика / Блоки управления
Блок управления Dynamic Drive	Электрика / Блоки управления
Блок управления ESP	Электрика / Блоки управления
Блок управления ICM	Электрика / Блоки управления
Блок управления REM	Электрика / Блоки управления
Блок управления SAM	Электрика / Блоки управления
Блок управления Smart Opener	Электрика / Блоки управления
Блок управления usb интерфейсом	Электрика / Блоки управления
Блок управления Valvetronic	Электрика / Блоки управления
Блок управления VDC	Электрика / Блоки управления
Блок управления ZGW	Электрика / Блоки управления
Блок управления АКПП	Электрика / Блоки управления
Блок управления антенной	Электрика / Блоки управления
Блок управления батареи	Электрика / Блоки управления
Блок управления беспроводной зарядкой	Электрика / Блоки управления
Блок управления блокировкой дифференциала	Электрика / Блоки управления
Блок управления бортовой сети	Электрика / Блоки управления
Блок управления вентилятором	Электрика / Блоки управления
Блок управления воротами гаража	Электрика / Блоки управления
Блок управления гибридной установкой	Электрика / Блоки управления
Блок управления гидроусилителем руля	Электрика / Блоки управления
Блок управления давления в шинах	Электрика / Блоки управления
Блок управления дверьми	Электрика / Блоки управления
Блок управления двигателем	Электрика / Блоки управления
Блок управления доп. насосом акпп	Электрика / Блоки управления
Блок управления дроссельной заслонкой	Электрика / Блоки управления
Блок управления зажиганием	Электрика
Блок управления замками	Электрика / Блоки управления
Блок управления зеркалами	Электрика / Блоки управления
Блок управления иммобилайзером	Электрика / Блоки управления
Блок управления интерфейсом	Электрика / Блоки управления
Блок управления камерой	Электрика / Блоки управления
Блок управления климат-контролем	Электрика / Блоки управления
Блок управления ключами	Электрика / Блоки управления
Блок управления кондиционера	Электрика / Блоки управления
Блок управления корректором фар	Электрика / Блоки управления
Блок управления круиз-контролем	Электрика / Блоки управления
Блок управления крышки багажника	Электрика / Блоки управления
Блок управления люком	Электрика / Блоки управления
Блок управления мультимедиа	Электрика / Блоки управления
Блок управления мультирулем	Электрика / Блоки управления
Блок управления навигацией	Электрика / Блоки управления
Блок управления онлайн-сервисов	Электрика / Блоки управления
Блок управления парковки	Электрика / Блоки управления
Блок управления парктрониками	Электрика / Блоки управления
Блок управления печки	Электрика / Блоки управления
Блок управления питанием	Электрика / Блоки управления
Блок управления пневмоподвеской	Электрика / Блоки управления
Блок управления подвеской	Электрика / Блоки управления
Блок управления подголовниками	Электрика / Блоки управления
Блок управления подогревом сидения	Электрика / Блоки управления
Блок управления полным приводом	Электрика / Блоки управления
Блок управления раздаточной коробки	Электрика / Блоки управления
Блок управления редуктором	Электрика / Блоки управления
Блок управления режимами подвески	Электрика / Блоки управления
Блок управления рулевого колеса	Электрика / Блоки управления
Блок управления рулевой колонки	Электрика / Блоки управления
Блок управления рулевой рейкой	Электрика / Блоки управления
Блок управления светом	Электрика / Блоки управления
Блок управления сервотроником	Электрика / Блоки управления
Блок управления сигналами	Электрика / Блоки управления
Блок управления сигнализатора движения	Электрика / Блоки управления
Блок управления сиденьем	Электрика / Блоки управления
Блок управления системой помощи водителю	Электрика / Блоки управления
Блок управления спойлером	Электрика / Блоки управления
Блок управления стабилизацией	Электрика / Блоки управления
Блок управления стеклоочистителей	Электрика / Блоки управления
Блок управления стеклоподъемниками	Электрика / Блоки управления
Блок управления стояночным тормозом	Электрика / Блоки управления
Блок управления телефоном	Электрика / Блоки управления
Блок управления топливным насосом	Электрика / Блоки управления
Блок управления турбины	Электрика / Блоки управления
Блок управления фаркопа	Электрика / Блоки управления
Блок управления форсунками	Электрика / Блоки управления
Блок управления центральным замком	Электрика / Блоки управления
Блок управления шасси	Электрика / Блоки управления
Блок цилиндров	Двигатель и элементы
Блоки прочие	Электрика / Блоки управления
Болт подрамника	Подвеска
Болт развала	Подвеска
Болты и гайки	Подвеска
Бортовой компьютер	Электрика / Блоки управления
Брызговик	Кузов и элементы
Бугель	Двигатель и элементы
Вакуумная трубка	Двигатель и элементы
Вакуумный клапан	Двигатель и элементы
Вакуумный насос	Тормозная система
Вакуумный ресивер	Двигатель и элементы
Вакуумный усилитель тормозов	Тормозная система
Вакуумный усилитель тормозов в сборе	Тормозная система
Вал вилки переключения передач	Трансмиссия
Вентилятор охлаждения батареи	Система охлаждения
Вентилятор охлаждения блоков управления	Электрика
Вентилятор охлаждения радиатора	Система охлаждения
Вентилятор сидения	Электрика
Ветровики комплект	Кузов и элементы
Видеомодуль high	Электрика
Визитница	Кузов и элементы
Вилка амортизатора	Подвеска
Вилка КПП	Трансмиссия
Вилка сцепления	Трансмиссия
Вискомуфта	Система охлаждения
Водосток	Кузов и элементы
Воздуховод	Кузов и элементы
Воздуховод бампера	Кузов и элементы
Воздуховод генератора	Двигатель и элементы
Воздуховод охлаждения батареи	Салон
Воздуховод радиатора	Кузов и элементы
Воздуховод салона	Салон
Воздуховод тормозов	Кузов и элементы
Воздуховод центральный	Салон
Воздухозаборник	Впускная система
Воздухозаборник капота	Кузов и элементы
Всасывающий патрубок	Двигатель и элементы
Вставка в гнездо свечи	Двигатель и элементы
Вторичный вал кпп	Трансмиссия
Втулка стабилизатора	Подвеска
Выжимной подшипник	Трансмиссия
Выключатель КПП с э/г приводом	Электрика / Кнопки
Выключатель сист.пассивной защиты детей	Электрика / Кнопки
Выключатель ТВ	Электрика / Кнопки
Выключатель центр.замка в случае аварии	Электрика / Датчики
Габарит	Оптика
Газовый баллон	Топливная система
Генератор	Электрика
Герметик для шин	Аксессуары
Гидравлика управления крыши	Электрика
Гидроаккумулятор подвески	Подвеска
Гидроблок АКПП	Трансмиссия
Гидротрансформатор	Трансмиссия
Главный тормозной цилиндр	Тормозная система
Главный цилиндр сцепления	Трансмиссия
Глушитель	Выпускная система
Глушитель пневмосистемы	Подвеска
Гнездо USB/AUX	Электрика
Головка блока цилиндров	Двигатель и элементы
Горловина бачка омывателя	Кузов и элементы
Горловина топливного бака	Топливная система
Гофра глушителя	Выпускная система
Гофра расходомера	Впускная система
Груша подкачки топлива	Топливная система
Губа бампера	Кузов и элементы
Датчик	Электрика / Датчики
Датчик ABS	Электрика / Датчики
Датчик NOX	Электрика двигателя
Датчик аккумулятора	Электрика / Датчики
Датчик влажности воздуха	Электрика / Датчики
Датчик впускного коллектора	Электрика двигателя
Датчик вращения АКПП	Электрика / Датчики
Датчик давления	Электрика / Датчики
Датчик давления в шинах	Электрика / Датчики
Датчик давления вакуумного усилителя	Электрика / Датчики
Датчик давления во впускном коллекторе	Электрика двигателя
Датчик давления воздуха	Электрика / Датчики
Датчик давления выхлопных газов	Электрика / Датчики
Датчик давления масла	Электрика двигателя
Датчик давления топлива	Электрика / Датчики
Датчик детонации	Электрика двигателя
Датчик дождя	Электрика / Датчики
Датчик дождя и света	Электрика / Датчики
Датчик запотевания	Электрика / Датчики
Датчик износа колодок	Электрика / Датчики
Датчик качества воздуха	Электрика / Датчики
Датчик кондиционера	Электрика / Датчики
Датчик крена	Электрика / Датчики
Датчик массового расхода воздуха	Электрика двигателя
Датчик наклона крышки багажника	Электрика / Датчики
Датчик наличия воды в топливном фильтре	Электрика / Датчики
Датчик объёма салона	Электрика / Датчики
Датчик отключения топливного насоса	Электрика / Датчики
Датчик открытия багажника	Электрика / Датчики
Датчик положения дроссельной заслонки	Электрика двигателя
Датчик положения коленвала	Электрика двигателя
Датчик положения кузова	Электрика / Датчики
Датчик положения педали газа	Электрика / Датчики
Датчик положения педали сцепления	Электрика / Датчики
Датчик положения педали тормоза	Электрика / Датчики
Датчик положения распредвала	Электрика двигателя
Датчик положения селектора АКПП	Электрика / Датчики
Датчик поперечного ускорения (ESP)	Электрика / Датчики
Датчик присутствия пассажира	Электрика / Датчики
Датчик света	Электрика / Датчики
Датчик сигнализации	Электрика / Датчики
Датчик скорости	Электрика / Датчики
Датчик слепых зон	Электрика / Датчики
Датчик температуры	Электрика / Датчики
Датчик температуры в салоне	Электрика / Датчики
Датчик температуры воздушной смеси	Электрика / Датчики
Датчик температуры всасываемого воздуха	Электрика двигателя
Датчик температуры выхлопных газов	Электрика / Датчики
Датчик температуры испарителя	Электрика / Датчики
Датчик температуры окружающей среды	Электрика / Датчики
Датчик температуры отопителя	Электрика / Датчики
Датчик температуры охлаждающей жидкости	Электрика / Датчики
Датчик температуры топлива	Электрика / Датчики
Датчик угла поворота заслонок	Электрика / Датчики
Датчик угла поворота руля	Электрика / Датчики
Датчик удара	Электрика / Датчики
Датчик удара двери	Airbag / Безопасность
Датчик удара центральной стойки	Airbag / Безопасность
Датчик уровня жидкости	Электрика / Датчики
Датчик уровня масла	Электрика двигателя
Датчик уровня топлива	Электрика / Датчики
Датчик холостого хода	Электрика двигателя
Датчик частоты вращения DSC	Электрика / Датчики
Дверная карта	Салон
Дверь	Наружные элементы кузова
Дверь голая	Наружные элементы кузова
Двигатель	Двигатель и элементы
Декор салона	Салон
Декоративная крышка двигателя	Двигатель и элементы
Декоративная накладка карты двери	Салон
Декоративная накладка торпедо	Салон
Декоративная накладка центральной консоли	Салон
Демпфер	Подвеска
Демпфер заднего подрамника	Подвеска
Демпфер крышки багажника	Кузов и элементы
Демпфер руля	Рулевое управление
Держатель подшипника кпп	Трансмиссия
Детали фары	Оптика
Деталь АКПП	Трансмиссия
Дефлектор воздуховода	Салон
Диагностический насос топливной системы	Топливная система
Динамик	Электрика
Динамик звука двигателя	Электрика
Динамометрический ключ	Аксессуары
Диск датчика коленвала	Двигатель и элементы
Диск колесный 5x100 R17x7j ET48	
Диск колесный 5x108 R17*7.0j ET50	
Диск колесный 5x108 R18 8Jx18xCH ET55	
Диск колёсный 5x112 R17 8Jx17 ET35	
Диск колёсный 5x112 R18 8,0JX18H2 ET47	
Диск колёсный 5x112 R18 8.0Jx18H2 ET40	
Диск колесный 5x112 R18 8Jx18H2 ET39	
Диск колесный 5x112 R18 8Jx18H2 IS30	
Диск колесный 5x112 R18 E-8.0Jx18H2 ET39	
Диск колёсный 5x112 R18 E7,5Jx18H2 ET51	
Диск колесный 5x112 R18x8J	
Диск колесный 5x112 R19 E8Jx19H2 ET39	
Диск колёсный 5x112 R20 8.0Jx20H2 ET39	
Диск колесный 5x112 R20 9.0Jx20H2 ET33	
Диск колёсный 5x112 R20 9Jx20H2 ET20	
Диск колесный 5x114.3 R16 16x6.5 ET50	
Диск колесный 5x114.3 R16 7j x16, 5 ET47	
Диск колесный 5x114.3 R17, 17x7 ET48	
Диск колёсный 5x114.3 R18 18X7,5J ET40	
Диск колесный 5x114.3 R19 7,5Jx19 ET49,5	
Диск колесный 5x114.3 R20 20x8 ET35	
Диск колесный 5x114.3 R22 22x9,5J ET15	
Диск колесный 5x120 R15 7Jx15 ET47	
Диск колесный 5x120 R15 7jx15h2 ET20	
Диск колесный 5x120 R17 17x7.5 ET37	
Диск колесный 5x120 R18 E8,5Jx18EH2 ET46	
Диск колесный 5x127 R18 18x8 ET56.4	
Диск колесный 5x130 R19 19x8,5JH2 ET53	
Диск колесный 5x130 R19 8,5Jx19 ET59	
Диск колесный 5x130 R19 8,5Jx19H2 ET59	
Диск колесный 5x130 R24 24x10J ET10	
диск колесный литой	
Диск сцепления	Трансмиссия
диск штампованный	
Диски	
Диски комплект 5x120 R15 7Jx15 ET40	
Диски комплект 5x120 R15 7jx15h2 ET20	
Диски с резиной	
Дисплей парктроника	Электрика
Дистиллированая вода	Система охлаждения
Дистроник	Электрика / Датчики
Дифференциал КПП	Трансмиссия
Диффузор радиатора	Кузов и элементы
Домкрат	Аксессуары
Дроссельная заслонка	Электрика двигателя
Ёмкость для хранения adblue	Топливная система
Жабо	Кузов и элементы
Жалюзи радиатора	Кузов и элементы
Жгут проводов для стартера и генератора	Электрика
Жгут проводов топливного бака	Электрика
Заглушка	Салон
Заглушка бампера	Кузов и элементы
Заглушка внешней ручки	Кузов и элементы
Заглушка гайки поводка дворника	Кузов и элементы
Заглушка опоры амортизатора	Кузов и элементы
Заглушка порога	Кузов и элементы
Заглушка противотуманной фары	Кузов и элементы
Заглушка рейлинга	Кузов и элементы
Заглушка ручки внутренней	Салон
Заглушка сидения	Салон
Заглушка торпедо	Салон
Заглушка центральной консоли	Салон
Заглушка центральной стойки	Салон
Задний диван	Салон
Задний фонарь	Оптика
Задняя крышка акпп в сборе	Трансмиссия
Задняя панель кузова	Кузов и элементы
Задняя полка	Салон
Замок багажника	Кузов и элементы
Замок бардачка	Салон
Замок двери	Кузов и элементы
Замок зажигания	Электрика
Замок капота	Кузов и элементы
Замок паркинга	Трансмиссия
Замок ремня безопасности	Airbag / Безопасность
Замок сиденья	Салон
Замок стекла крышки багажника	Кузов и элементы
Запасное колесо	Аксессуары
Зарядное устройство	Электрика
Зарядный блок устройства громкой связи	Электрика / Блоки управления
Заслонка	Двигатель и элементы
Заслонка впускного колектора	Впускная система
Защита	Кузов и элементы
Защита аккумулятора	Кузов и элементы
Защита арки	Кузов и элементы
Защита балки	Кузов и элементы
Защита бампера	Кузов и элементы
Защита батареи	Кузов и элементы
Защита бачка тормозной жидкости	Тормозная система
Защита двигателя	Кузов и элементы
Защита днища	Кузов и элементы
Защита коллектора	Выпускная система
Защита масляного фильтра	Двигатель и элементы
Защита полуоси	Трансмиссия
Защита проводки	Кузов и элементы
Защита ремня ГРМ	Двигатель и элементы
Защита ремня обводного	Двигатель и элементы
Защита рулевой рейки	Рулевое управление
Защита рычага	Трансмиссия
Защита топливного абсорбера	Кузов и элементы
Защита топливного бака	Кузов и элементы
Защита топливных трубок	Кузов и элементы
Защита трансмисии	Кузов и элементы
Защита турбины	Выпускная система
Защитный кожух катушки	Двигатель и элементы
Звезда	Двигатель и элементы
Звезда коленвала	Двигатель и элементы
Звезда распредвала	Двигатель и элементы
Звезда цепи ГРМ	Двигатель и элементы
Зеркало	Стекла и зеркала
Зеркало салона	Стекла и зеркала
Зеркальный элемент	Стекла и зеркала
Знак аварийной остановки	Аксессуары
Зуммер	Электрика
Инвертор	Электрика
Индикатор ремня/подушки безопасности	Электрика
Индикатор селектора акпп	Электрика
Инерционный выключатель топливного насоса	Электрика / Кнопки
Инерционный демпфер	Трансмиссия
Интеркулер	Система охлаждения
Информационный дисплей	Электрика
Испаритель кондиционера	Отопление и кондиционирование
Кабель высоковольтный	Электрика
Камера	Электрика
Камера бокового обзора	Электрика
Камера вспомогательных систем водителя	Электрика
камера заднего вида	Электрика
Камера переднего вида	Электрика
Капот	Кузов и элементы
Карбюратор	Топливная система
Карданный вал	Трансмиссия
Картоприёмник	Электрика
Катализатор	Выпускная система
Катафот бампера	Кузов и элементы
Катафот двери	Кузов и элементы
Катушка зажигания	Электрика двигателя
Клапан	Двигатель и элементы
Клапан EGR с радиатором	Двигатель и элементы
Клапан Абсорбера	Топливная система
Клапан вакуумного усилителя тормозов	Тормозная система
Клапан вентиляции	Кузов и элементы
Клапан вентиляции картерных газов	Двигатель и элементы
Клапан вентиляции салона	Кузов и элементы
Клапан вентиляции топливного бака	Топливная система
Клапан выпускного коллектора	Выпускная система
Клапан ЕГР	Двигатель и элементы
Клапан испарителя кондиционера	Отопление и кондиционирование
Клапан кондиционера	Отопление и кондиционирование
Клапан контроля уровня масла Акпп	Трансмиссия
Клапан печки	Отопление и кондиционирование
Клапан регулировки давления масла	Электрика двигателя
Клапан системы охлаждения	Электрика / Кнопки
Клапан сцепления	Трансмиссия
Клапан фазорегулятора	Электрика двигателя
Клапан электромагнитный	Электрика
Клемма	Электрика
Клемма минусовая	Электрика
Клемма плюсовая	Электрика
Клипса	Кузов и элементы
Клипса кузова	Кузов и элементы
Ключ	Электрика
Ключ - карта	Электрика
Ключ аварийной разблокировки АКПП	Аксессуары
Ключ колпака ступицы	Аксессуары
Кнопка AirBag	Электрика / Кнопки
Кнопка ASC	Электрика / Кнопки
Кнопка Drive Mode	Электрика / Кнопки
Кнопка DSC	Электрика / Кнопки
Кнопка Eco mode	Электрика / Кнопки
Кнопка EDC	Электрика / Кнопки
Кнопка ESP	Электрика / Кнопки
Кнопка Heat	Электрика / Кнопки
Кнопка kickdown	Электрика / Кнопки
Кнопка Main	Электрика / Кнопки
Кнопка Off Road	Электрика / Кнопки
Кнопка Sport	Электрика / Кнопки
кнопка SRF	Электрика / Кнопки
Кнопка SRH	Электрика / Кнопки
Кнопка Start Stop	Электрика / Кнопки
Кнопка TCS	Электрика / Кнопки
Кнопка VALET	Электрика / Кнопки
Кнопка аварийной сигнализации	Электрика / Кнопки
Кнопка автопарковки	Электрика / Кнопки
Кнопка антены	Электрика / Кнопки
Кнопка антипробуксовочной системы	Электрика / Кнопки
Кнопка асиссистента смены полосы	Электрика / Кнопки
Кнопка блокировки центрального замка	Электрика / Кнопки
Кнопка включения беспроводной зарядки	Электрика / Кнопки
Кнопка включения полного привода	Электрика / Кнопки
Кнопка выключатель солнцезащитной шторы	Электрика / Кнопки
Кнопка дефлектора салона	Электрика / Кнопки
Кнопка дистроника	Электрика / Кнопки
Кнопка заднего стеклоочистителя	Электрика / Кнопки
Кнопка индикатора давления шин	Электрика / Кнопки
Кнопка климат контроля	Электрика / Кнопки
Кнопка корректора фар	Электрика / Кнопки
Кнопка круиз контроля	Электрика / Кнопки
Кнопка многофункциональная	Электрика / Кнопки
Кнопка омывателя фар	Электрика / Кнопки
Кнопка освещения багажного отсека	Электрика / Кнопки
Кнопка освещения панели приборов	Электрика / Кнопки
Кнопка освещения салона	Электрика / Кнопки
Кнопка отключения сигнализации	Электрика / Кнопки
Кнопка открывания крышки багажника	Электрика / Кнопки
Кнопка открытия лючка зарядки	Электрика / Кнопки
Кнопка открытия лючка топливного бака	Электрика / Кнопки
Кнопка памяти сидения	Электрика / Кнопки
Кнопка парктроника	Электрика / Кнопки
Кнопка переключатель режимов АКП	Электрика / Кнопки
Кнопка подголовников	Электрика / Кнопки
Кнопка подогрева заднего стекла	Электрика / Кнопки
Кнопка подогрева руля	Электрика / Кнопки
Кнопка подогрева сиденья	Электрика / Кнопки
Кнопка помощи при подъеме	Электрика / Кнопки
Кнопка помощи при спуске	Электрика / Кнопки
Кнопка противотуманных фар	Электрика / Кнопки
Кнопка регулировки высоты подвески	Электрика / Кнопки
Кнопка регулировки громкости	Электрика / Кнопки
Кнопка регулировки зеркала	Электрика / Кнопки
Кнопка регулировки положения руля	Электрика / Кнопки
Кнопка регулировки рулевой колонки	Электрика / Кнопки
Кнопка регулировки сиденья	Электрика / Кнопки
Кнопка сброса пробега	Электрика / Кнопки
Кнопка сдвижной крышки люка	Электрика / Кнопки
Кнопка системы пассивной безопасности	Электрика / Кнопки
Кнопка складывания крыши	Электрика / Кнопки
Кнопка складывания сиденья	Электрика / Кнопки
Кнопка слепых зон	Электрика / Кнопки
Кнопка стеклоподъемника	Электрика / Кнопки
Кнопка стояночного тормоза	Электрика / Кнопки
Кнопка управления Бортовым Компьютером	Электрика / Кнопки
Кнопка функции массажа	Электрика / Кнопки
Кнопка шторы панорамы	Электрика / Кнопки
Кнопка экстренного вызова	Электрика / Кнопки
Кнопкам блокировки детского замка	Электрика / Кнопки
Кнопки мультимедиа	Электрика / Кнопки
Кнопки прочие	Электрика / Кнопки
Кнопки руля	Электрика / Кнопки
Коврик багажника	Салон
Коврик багажника на спинке сидений	Салон
Коврик карты двери	Кузов и элементы
Коврик салона	Салон
Коврик центральной консоли	Салон
Ковролин	Салон
Кожух выпускного коллектора	Выпускная система
Кожух замка капота	Кузов и элементы
Кожух рулевой колонки	Салон
Кожух рулевой колонки верхний	Салон
Кожух рулевой колонки нижний	Салон
Козырек солнцезащитный	Салон
Коленвал	Двигатель и элементы
Колёсная проставка	Подвеска
Коллектор впускной	Впускная система
Коллектор выпускной	Выпускная система
Колодка силовая	Электрика
Колодки стояночного тормоза	Тормозная система
Колпак колесный	Аксессуары
Колпачок колеса декоративный	Аксессуары
Компенсатор LTE	Электрика
Комплект брызговиков	Кузов и элементы
Комплект ГБО 4 поколения	Топливная система
Комплект ГРМ	Двигатель и элементы
Комплект дисков 5x100 R17 17x7j ET48.	
Комплект дисков 5x112 R17 7Jx17H2 ET43	
Комплект дисков 5x112 R17 8jx17h2 ET48	
Комплект дисков 5x112 R17 E7,5Jx17H2 ET38	
Комплект дисков 5x112 R18 8,0Jx18H2 ET47	
Комплект дисков 5x112 R18 8.0Jx18H2 ET39	
Комплект дисков 5x112 R18 8Jx18, ET45	
Комплект дисков 5x112 R18 8Jx18H2 ET46	
Комплект дисков 5x112 R18 8Jx18H2 ET47	
Комплект дисков 5x112 R18 E8.0jx18H2 ET40	
Комплект дисков 5x112 R19 8,5Jx19H2 ET32	
Комплект дисков 5x112 R19 E8,5Jx19H2 ET32	
Комплект дисков 5x112 R19 E8Jx19H2 ET39	
Комплект дисков 5x112 R20 9.0Jx20H2 ET33	
Комплект дисков 5x112 R20 9jx20h2 ET37	
Комплект дисков 5x112 R20 E-9.Jx20H2-N ET28	
Комплект дисков 5x114.3 R16 16x6,5J ET46	
Комплект дисков 5x114.3 R17 17х7j.	
Комплект дисков 5x115 R17 17j7j ET46	
Комплект дисков 5x120 R15 7Jx15 ET40	
Комплект дисков 5x120 R15 7jx15h2 ET20	
Комплект дисков 5x120 R16 7,5 Jx16 H2, ET20 Borbet	
Комплект дисков 5x120 R17 7Jx17H2 IS40	
Комплект дисков 5x120 R17 8Jx17EH2 IS30	
Комплект дисков 5x120 R17 8Jx17EH2 IS34	
Комплект дисков 5x120 R17 E-8Jx17 EH2+ IS43	
Комплект дисков 5x120 R17 E-8Jx17 EJ2+ IS43	
Комплект дисков 5x120 R18 7,5Jx18H2 ET45	
Комплект дисков 5x120 R18 7.5jx18h2 ET45	
Комплект дисков 5x120 R18 8Jx18 EH2 IS30	
Комплект дисков 5x120 R18 8Jx18 EH2+ IS43	
Комплект дисков 5x120 R18 8Jx18EH2+ IS30	
Комплект дисков 5x120 R18 E8,5Jx18 EH2+ IS46	
Комплект дисков 5x120 R18 E8,5Jx18EH2+ IS48	
Комплект дисков 5x120 R19 19x9,5J ET35	
Комплект дисков 5x120 R19 8,5Jx19EH2 IS25	
Комплект дисков 5x120 R19 8.0Jx19H2 ET43	
Комплект дисков 5x120 R19 9Jx19 EH2+ IS48	
Комплект дисков 5x120 R20 11Jx20 IS35 10Jx20 IS40	
Комплект дисков 5x127 R17 17x8 ET56,4	
Комплект дисков 5x127 R20 20x8.0J ET56.4	
Комплект дисков 5x130 R18 8Jx18H2 ET53	
Комплект дисков 5x130 R18 E8,5Jx18H2 ET58	
Комплект дисков 5x130 R19 8,5Jx19 ET59	
Комплект дисков 5x130 R19 8,5Jx19H2 ET59	
Комплект дисков 5x130 R19 8,5Jx19H2 ET62	
Комплект дисков 5x130 R19 8,5Jx19J2 ET59	
Комплект дисков 5x130 R20 9jx20h2 ET57	
Комплект дисков 5x130 R20 Talladega 9Jx20H2 ET57	
Комплект дисков 6x120 R20 20x8J IS50	
Комплект инструмента	Аксессуары
Комплект ковриков	Салон
Комплект колёсных секреток	Аксессуары
Комплект пружин с занижением	Подвеска
Комплект разношироких дисков 5x120 11Jx20 EH2 IS37, 10Jx20 EH2 IS40	
Комплект разношироких дисков 5x120 R19 19x9,5J ET35	
Комплект разношироких дисков 5x120 R19 19x9,5J ET35. 19x8,5J ET35	
Комплект разношироких дисков 5x120 R19 8,5Jx19 EH2 IS25, 9,5Jx19 EH2 IS39	
Комплект разношироких дисков 5x120 R20 11Jx20 EH2 IS37, 10Jx20 EH2 IS40	
Комплект разношироких дисков 5x120 r20 11jx20 is35 10jx20 is40	
Комплект разношироких дисков R19 8,5Jx19 EH2 IS25, 9,5Jx19 EH2 IS39	
Комплект сидений	Салон
Комплект суппортов с тормозными дисками	Тормозная система
Комплект сцепления	Трансмиссия
Комплект эмблем	Кузов и элементы
Компресор подкачки сидений	Салон
Компрессор ДВС	Впускная система
Компрессор для подкачки шин	Аксессуары
Компрессор кондиционера	Отопление и кондиционирование
Компрессор подвески	Подвеска
Компрессор центрального замка	Электрика
Конденсатор зажигания	Электрика
Конденсатор подавления радиопомех	Электрика
Контактная группа	Электрика
Контроллер ASSY-ADAS	Электрика / Блоки управления
Концевик	Электрика
Концевик двери	Электрика
Концевик капота	Электрика / Датчики
Концевик крышки багажника	Электрика / Датчики
Концевик педали сцепления	Электрика / Датчики
Концевик педали тормоза	Электрика / Датчики
Концевик электро крыши	Электрика
Корзина сцепления	Трансмиссия
Корпус антенны	Кузов и элементы
Корпус бардачка	Салон
Корпус блока предохранителей	Кузов и элементы
Корпус вентилятора кондиционера	Отопление и кондиционирование
Корпус вентилятора печки	Кузов и элементы
Корпус воздухозаборника печки	Отопление и кондиционирование
Корпус воздушного фильтра	Впускная система
Корпус динамика	Салон
Корпус клапан ЕГР	Двигатель и элементы
Корпус компрессора	Двигатель и элементы
Корпус КПП	Трансмиссия
Корпус масляного фильтра	Двигатель и элементы
Корпус печки	Отопление и кондиционирование
Корпус подрулевого переключателя	Электрика
Корпус помпы	Система охлаждения
Корпус регуляторов фаз грм	Двигатель и элементы
Корпус термостата	Система охлаждения
Корпус термостата с помпой	Система охлаждения
Корпус топливного фильтра	Топливная система
Корпус фильтра салона	Отопление и кондиционирование
Корпус ЭБУ	Кузов и элементы
Корректор фары	Оптика
Крепление аккумулятора	Кузов и элементы
Крепление амортизатора багажника	Кузов и элементы
Крепление багажника	Салон
Крепление бампера	Кузов и элементы
Крепление вакуумного усилителя	Двигатель и элементы
Крепление замка двери	Кузов и элементы
Крепление замка капота	Кузов и элементы
Крепление запасного колеса	Кузов и элементы
Крепление знака аварийной остановки	Аксессуары
Крепление камеры	Кузов и элементы
Крепление крыла	Кузов и элементы
Крепление крышки багажника	Кузов и элементы
Крепление кулисы КПП	Кузов и элементы
Крепление лючка бака	Кузов и элементы
Крепление насоса	Кузов и элементы
Крепление парктроника	Кузов и элементы
Крепление переносной лампы с подзарядкой	Электрика
Крепление порога	Кузов и элементы
Крепление проводки	Кузов и элементы
Крепление противотуманной фары	Кузов и элементы
Крепление прочее	Кузов и элементы
Крепление радиатора	Кузов и элементы
Крепление решётки радиатора	Кузов и элементы
Крепление рулевой рейки	Рулевое управление
Крепление сетки багажника	Салон
Крепление топливного бака	Топливная система
Крепление усилителя антенны	Кузов и элементы
Крепление фонаря	Кузов и элементы
Крепление центральной консоли	Салон
Крепления батареи	Кузов и элементы
Крепления дополнительного радиатора	Кузов и элементы
Крепления топливного фильтра	Кронштейны двигателя
Кронштейн	Двигатель и элементы
Кронштейн Airbag	Салон
Кронштейн абсорбера	Кузов и элементы
Кронштейн АКПП	Трансмиссия
Кронштейн амортизатора капота	Кузов и элементы
Кронштейн балки	Подвеска
Кронштейн бардачка	Салон
Кронштейн бачка омывателя	Кузов и элементы
Кронштейн блока ABS	Тормозная система
Кронштейн блока комфорта	Кузов и элементы
Кронштейн блока мультимедиа	Салон
Кронштейн блока предохранителей	Кузов и элементы
Кронштейн блока системы открывания ворот гаража	Кузов и элементы
Кронштейн блока управления	Кузов и элементы
Кронштейн блока управления двигателем	Кузов и элементы
Кронштейн блока управления климатом	Салон
Кронштейн вакуумного клапана	Кронштейны двигателя
Кронштейн впускного коллектора	Кронштейны двигателя
Кронштейн вывода плюса аккумулятора B+	Электрика
Кронштейн выпускного коллектора	Выпускная система
Кронштейн генератора	Кронштейны двигателя
Кронштейн глушителя	Выпускная система
Кронштейн датчика слепых зон	Кузов и элементы
Кронштейн датчика удара	Салон
Кронштейн двигателя	Кронштейны двигателя
Кронштейн дистроника	Кузов и элементы
Кронштейн дополнительного насоса ОЖ	Кронштейны двигателя
Кронштейн дросельной заслонки	Кронштейны двигателя
Кронштейн заднего сиденья	Салон
Кронштейн замка багажника	Кузов и элементы
Кронштейн защиты двигателя	Кронштейны двигателя
Кронштейн звукового сигнала	Кузов и элементы
Кронштейн инвертора	Электрика
Кронштейн клапана EGR	Кронштейны двигателя
Кронштейн компрессора кондиционера	Кронштейны двигателя
Кронштейн компрессора подвески	Подвеска
Кронштейн корпуса воздушного фильтра	Кронштейны двигателя
Кронштейн КПП	Трансмиссия
Кронштейн крепление катализатора	Выпускная система
Кронштейн крепление турбины	Кронштейны двигателя
Кронштейн крепления селектора акпп	Салон
Кронштейн лонжерона	Кузов и элементы
Кронштейн магнитофона	Салон
Кронштейн масляного фильтра	Кронштейны двигателя
Кронштейн модуля центрального замка	Кузов и элементы
Кронштейн насоса вторичного воздуха	Кронштейны двигателя
Кронштейн насоса гидроусилителя	Кронштейны двигателя
Кронштейн облицовки днища кузова	Кузов и элементы
Кронштейн опоры амортизатора	Подвеска
Кронштейн опоры карданного вала	Трансмиссия
Кронштейн педального механизма	Салон
Кронштейн передней панели	Кузов и элементы
Кронштейн плафона салона	Салон
Кронштейн подвесного подшипника	Трансмиссия
Кронштейн подрамника	Подвеска
Кронштейн подушки двигателя	Кронштейны двигателя
Кронштейн пола	Салон
Кронштейн продольного рычага	Подвеска
Кронштейн промежуточного вала	Трансмиссия
Кронштейн радиатора	Кузов и элементы
Кронштейн радиатора EGR	Кронштейны двигателя
Кронштейн радиатора гидроусилителя	Кронштейны двигателя
Кронштейн раздатки	Трансмиссия
Кронштейн расширительного бачка	Кузов и элементы
Кронштейн редуктора	Трансмиссия
Кронштейн рейлинга	Кузов и элементы
Кронштейн ремня безопасности	Салон
Кронштейн ручки багажника	Салон
Кронштейн ручки двери	Кузов и элементы
Кронштейн ручки открывания капота	Салон
Кронштейн ручки потолка	Салон
Кронштейн рычага подвески	Подвеска
Кронштейн сажевого фильтра	Кронштейны двигателя
Кронштейн сидения	Салон
Кронштейн сирены сигнализации	Кузов и элементы
Кронштейн спойлера	Кузов и элементы
Кронштейн стекла	Кузов и элементы
Кронштейн стойки стабилизатора	Подвеска
Кронштейн ступицы	Подвеска
Кронштейн термостата	Кронштейны двигателя
Кронштейн ТНВД	Кронштейны двигателя
Кронштейн топливной рампы	Кронштейны двигателя
Кронштейн торпедо	Салон
Кронштейн турбины	Кронштейны двигателя
Кронштейн усилителя бампера	Стекла и зеркала
Кронштейн усилителя звука	Кузов и элементы
Кронштейн фары	Кузов и элементы
Кронштейн фонаря в подкапотном пространстве	Кузов и элементы
Кронштейн форсунки	Топливная система
Кронштейн шторки багажника	Салон
Крыло	Наружные элементы кузова
Крыльчатка вентилятора кондиционера	Система охлаждения
Крыльчатка вентилятора охлаждения	Система охлаждения
Крыша	Кузов и элементы
Крышка	Салон
Крышка аккумулятора	Кузов и элементы
Крышка Акпп	Трансмиссия
Крышка багажника	Кузов и элементы
Крышка багажного отсека	Салон
Крышка бардачка	Салон
Крышка бачка ГУР	Рулевое управление
Крышка бачка омывателя	Кузов и элементы
Крышка бачка тормозной жидкости	Тормозная система
Крышка бегунка	Двигатель и элементы
Крышка блока Abs	Тормозная система
Крышка блока предохранителей	Двигатель и элементы
Крышка блока реле	Кузов и элементы
Крышка блока управления	Кузов и элементы
Крышка вещевого отсека	Салон
Крышка воздухозаборника	Кузов и элементы
Крышка гбц	Двигатель и элементы
Крышка двигателя	Двигатель и элементы
Крышка диагностического разьёма	Кузов и элементы
Крышка динамика	Салон
Крышка динамика в торпедо	Салон
Крышка канала вентиляции тормозов	Кузов и элементы
Крышка клапанов	Двигатель и элементы
Крышка корпуса воздушного фильтра	Впускная система
Крышка корпуса кпп	Трансмиссия
Крышка корпуса печки	Отопление и кондиционирование
Крышка маслозаливной горловины	Двигатель и элементы
Крышка масляного насоса	Двигатель и элементы
Крышка масляного фильтра	Двигатель и элементы
Крышка моторной проводки	Двигатель и элементы
Крышка моторчика дворников	Кузов и элементы
Крышка панели приборов	Салон
Крышка плюсовой клеммы	Электрика / Кнопки
Крышка подлокотника	Салон
Крышка предохранителей	Салон
Крышка проводов зажигание	Кузов и элементы
Крышка радиатора	Система охлаждения
Крышка распредвала	Двигатель и элементы
Крышка расширительного бачка	Система охлаждения
Крышка стартера	Двигатель и элементы
Крышка топливного бака	Топливная система
Крышка усилителя звука	Салон
Крышка фары	Оптика
Крышка фильтра салона	Кузов и элементы
Крышка фонаря	Салон
Крышка форсунки омывателя фар	Кузов и элементы
Крюк буксировочный	Стекла и зеркала
Крюк для подъема двигателя	Кронштейны двигателя
Кузов под кунг	Наружные элементы кузова
Кулиса КПП	Трансмиссия
Кунг	Кузов и элементы
Лампочка	Оптика
Личинка замка двери	Кузов и элементы
Личинка замка двери с заглушкой	Кузов и элементы
Личинка замка двери с ключом	Кузов и элементы
Лобовое стекло	Стекла и зеркала
Лонжерон	Кузов и элементы
Лоток багажника	Салон
Лоток для запасного колеса	Салон
Люк	Кузов и элементы
Люк панорама в сборе	Кузов и элементы
Лючок разъёма зарядки	Кузов и элементы
Лючок топливного бака	Кузов и элементы
Лямбда зонд	Электрика двигателя
Магазин CD-чейнджера	Электрика
Магнитофон	Электрика
Масло моторное	Двигатель и элементы
Маслозаливная горловина	Двигатель и элементы
Маслонасос	Двигатель и элементы
Маслонасос Акпп	Трансмиссия
Маслоотделитель	Двигатель и элементы
Маслоотражатель	Двигатель и элементы
Маслоприемник	Двигатель и элементы
Масляный щуп	Двигатель и элементы
Масляный щуп акпп	Трансмиссия
Маховик	Двигатель и элементы
Механизм VANOS	Двигатель и элементы
Механизм блокировки руля	Рулевое управление
Механизм выбора передач	Трансмиссия
Механизм открывания люка	Салон
Механизм подачи ремня безопасности	Салон
Механизм подъема запасного колеса	Кузов и элементы
Механизм стеклоподъемника	Кузов и элементы
Механизм стеклоподъемника с мотором	Кузов и элементы
Микрофон	Электрика
МКПП	Трансмиссия
Модуль BCM	Электрика / Блоки управления
Модуль датчиков	Электрика
Модуль катушек зажигания	Электрика двигателя
Модуль межсетевого преобразования	Электрика / Блоки управления
Модуль распредвалов	Двигатель и элементы
Молдинг бампера	Кузов и элементы
Молдинг двери (уголок) внешний	Наружные элементы кузова
Молдинг двери (уголок) внутренний	Кузов и элементы
Молдинг двери внешний	Кузов и элементы
Молдинг капота	Кузов и элементы
Молдинг крыла	Кузов и элементы
Молдинг крыши	Кузов и элементы
Молдинг лобового стекла	Кузов и элементы
Молдинг решетки радиатора	Кузов и элементы
Молдинг стекла	Кузов и элементы
Молдинг стекла внутренний	Наружные элементы кузова
Молдинг стойки внешний	Наружные элементы кузова
Монетница	Салон
Монитор	Электрика
Мост	Трансмиссия
Мотор Valvetronic	Электрика двигателя
Мотор вентилятора охлаждения	Электрика
Мотор дворников	Электрика
Мотор замка двери	Электрика
Мотор люка	Электрика
Мотор омывателя	Электрика
Мотор омывателя фар	Электрика
Мотор печки	Отопление и кондиционирование
Мотор стеклоподъемника	Электрика
Мотор стояночного тормоза	Тормозная система
Мотор шторки	Электрика
Моторчик вибрации руля	Электрика
Моторчик датчика температуры в салоне	Электрика
Моторчик жалюзи	Электрика
Моторчик регулировки рулевой колонкой	Электрика
Моторчик регулировки сидения	Электрика
Моторчик регулировки фар	Электрика
Муфта кпп	Трансмиссия
Нагреватель впускного коллектора	Двигатель и элементы
Нагреватель охлаждающей жидкости	Отопление и кондиционирование
Нагревательный элемент	Отопление и кондиционирование
Накладка бардачка	Салон
Накладка выключателя света	Салон
Накладка двери боковая	Кузов и элементы
Накладка двери внешняя	Кузов и элементы
Накладка двери внутренняя	Салон
Накладка ДМРВ	Двигатель и элементы
Накладка замка двери	Салон
Накладка замка крышки багажника	Салон
Накладка зеркала	Салон
Накладка зеркала в салоне	Салон
Накладка камеры	Салон
Накладка капота	Кузов и элементы
Накладка кнопок	Салон
Накладка кнопок света	Салон
Накладка кнопок стеклоподъемника	Салон
Накладка крышки багажника	Кузов и элементы
Накладка на бампер	Кузов и элементы
Накладка на жабо	Кузов и элементы
Накладка на крыло	Кузов и элементы
Накладка на порог	Кузов и элементы
Накладка панели приборов	Салон
Накладка педали	Салон 
Накладка передней панели	Кузов и элементы
Накладка петли капота	Кузов и элементы
Накладка петли крышки багажника	Салон
Накладка под фару	Кузов и элементы
Накладка подголовника	Салон
Накладка потолка	Салон
Накладка противотуманной фары	Кузов и элементы
Накладка ремня безопасности	Салон
Накладка руля	Салон
Накладка ручки внутренней	Салон
Накладка ручки люка	Салон
Накладка сидения	Салон
Накладка стойки	Кузов и элементы
Накладка стойки лобового стекла	Кузов и элементы
Накладка стоп-сигнала	Салон
Накладка торпедо нижняя	Салон
Накладка торпеды	Салон
Накладка торпеды боковая	Салон
Накладка фонаря заднего	Кузов и элементы
Накладка форточки	Кузов и элементы
Накладка центральной консоли	Салон
Накладка щитка приборов	Салон
Накладки прочие	Салон
Наполнитель двери	Кузов и элементы
Направляющая двери	Кузов и элементы
Направляющая масляного щупа	Двигатель и элементы
Направляющая подголовника	Салон
Направляющая стекла двери	Кузов и элементы
Насадка глушителя	Выпускная система
Насос ABS	Тормозная система
Насос вторичного воздуха	Выпускная система
Насос гидроусилителя руля	Рулевое управление
Насос крышки багажника	Кузов и элементы
Натяжитель приводного ремня	Двигатель и элементы
Натяжитель цепи	Двигатель и элементы
Обивка сидения	Аксессуары
Облицовка щита передка, нижняя часть	Кузов и элементы
Обратный клапан	Топливная система
Обратный маслопровод турбины	Впускная система
Обшивка	Салон
Обшивка багажника	Салон
Обшивка крышки багажника	Салон
Обшивка потолка	Салон 
Обшивка ручки подлокотника	Салон
Обшивка салона	Салон
Обшивка Стойки	Салон
Обшивка стойки верхняя	Салон
Обшивка стойки нижняя	Салон
Обшивка стойки центральная	Салон
Ограничитель двери	Кузов и элементы
Ограничитель крышки багажника	Кузов и элементы
Омыватель стекла	Кузов и элементы
Опора пружины верхняя	Подвеска
Опора стойки	Подвеска
Опорная планка распредвала	Двигатель и элементы
Опорный кронштейн распредвала	Двигатель и элементы
Осушитель кондиционера	Отопление и кондиционирование
Отбойник крышки багажника	Кузов и элементы
Отвертка	Аксессуары
Ответная часть замка багажника	Кузов и элементы
Ответная часть замка двери	Кузов и элементы
Ответная часть замка капота	Кузов и элементы
Панель для телефона	Салон
Панель подсветки номера	Кузов и элементы
Панель приборов	Салон
Панель управления климат-контролем	Электрика / Блоки управления
Панель управления мультимедиа	Электрика / Блоки управления
Парктроник	Электрика / Датчики
Патрон фары	Оптика
Патрубок	Система охлаждения
Патрубок вентиляции топливного бака	Топливная система
Патрубок воздушного фильтра	Впускная система
Патрубок впускного колектора	Впускная система
Патрубок интеркулера	Двигатель и элементы
Педаль газа	Электрика двигателя
Педаль отдыха ноги	Салон
Педаль стояночного тормоза	Тормозная система
Педаль сцепления	Салон
Педаль тормоза с кронштейном	Тормозная система
Пепельница	Салон
Первичный вал кпп	Трансмиссия
Первичный вал масляного насоса	Двигатель и элементы
Перегородка моторного отсека	Кузов и элементы
Передние сидения	Салон
Передняя крышка мотора	Двигатель и элементы
Переключатель дворников	Электрика
Переключатель круиз-контроля	Электрика
Переключатель поворотов	Электрика
Переключатель света	Электрика
Переходная плита КПП	Трансмиссия
Петля багажника	Кузов и элементы
Петля двери	Кузов и элементы
Петля капота	Кузов и элементы
Печка в сборе	Отопление и кондиционирование
Печка салона задняя	Отопление и кондиционирование
Пиропатрон	Airbag / Безопасность
Пиропатрон акб	Электрика
Планетарная передача с обгонной муфтой	Трансмиссия
Планка передней панели	Кузов и элементы
Планка телевизора верхняя	Кузов и элементы
Планка телевизора нижняя	Кузов и элементы
Пластик под рулевой	Салон
Пластик подкапотный	Кузов и элементы
Пластик салона	Салон
Пластина звукового сигнала	Электрика
Плата фонаря	Оптика
Плафон багажника	Салон
Плафон карты двери	Электрика
Плафон подсветки бардачка	Электрика
Плафон подсветки ног	Электрика
Плафон подсветки номера	Оптика
Плафон салона	Салон
Площадка аккумулятора	Кузов и элементы
Площадка номерного знака	Кузов и элементы
Пневматический узел	Подвеска
Пневмоаккумулятор	Электрика
Пневмоамортизатор подвески	Подвеска
Поводка дверная	Электрика
Поводок дворника	Кузов и элементы
Поворотный кулак	Подвеска
Повторитель поворота	Оптика
Повторитель поворота в зеркале	Оптика
Повторитель стоп сигнала	Оптика
Подголовник	Салон
Поддомкратник	Кузов и элементы
Поддон АКПП	Трансмиссия
Поддон двигателя	Двигатель и элементы
Подкачивающий насос DSC	Тормозная система
Подкрылок	Кузов и элементы
Подлокотник	Салон
Подножка	Кузов и элементы
Подрамник	Подвеска
Подрулевой шлейф	Электрика
Подсветка ручки	Электрика
Подсветка торпеды	Электрика
Подстаканник	Салон
Подушка глушителя	Выпускная система
Подушка двигателя	Двигатель и элементы
Подушка КПП	Трансмиссия
Подушка пневмоподвески	Подвеска
Подушка рамы кузова	Трансмиссия
Подушка редуктора	Трансмиссия
Подшипник опоры амортизатора	Подвеска
Пол Багажника	Салон
Полка багажника	Салон
Полуподдон масляный	Двигатель и элементы
Помехоподавляющий фильтр	Электрика
Помпа	Система охлаждения
Помпа электрическая	Электрика
Порт зарядки с кабелем	Электрика
Поршень	Двигатель и элементы
Поршень Акпп	Трансмиссия
Поршень с шатуном	Двигатель и элементы
Предохранитель	Электрика
Предохранитель батареи	Электрика
Предохранитель на клемме аккумулятора	Электрика
Преобразователь напряжения	Электрика
Привод	Трансмиссия
Привод MULTIAIR	Двигатель и элементы
Привод двери багажника	Электрика
Привод замка багажника	Электрика
Привод заслонки коллектора	Впускная система
Привод заслонки отопителя	Отопление и кондиционирование
Привод лючка топливного бака	Электрика
Привод подголовника	Электрика
Привод солнцезащитной шторки	Электрика
Приемо-передающий модуль	Электрика
Прикуриватель	Электрика
Провод AUX	Электрика
Провод датчика ABS	Электрика
Провод датчика мёртвых зон	Электрика
Провод массы	Электрика
Провод минусовой	Электрика
Провод плюсовой	Электрика
Провод плюсовой клеммы	Электрика
Провода AirBag	Airbag / Безопасность
Провода высоковольтные	Электрика
Провода прочие	Электрика
Провода торпедо	Электрика
Проводка Valvetronic	Электрика двигателя
Проводка абсорбера	Электрика
Проводка АКБ	Электрика
Проводка АКПП	Электрика
Проводка актуатора турбины	Электрика двигателя
Проводка антенны	Электрика
Проводка бампера	Электрика
Проводка бардачка	Электрика
Проводка высоковольтной батареи	Электрика
Проводка датчика давления масла	Электрика двигателя
Проводка дверная	Электрика
Проводка камеры	Электрика
Проводка катушки зажигания	Электрика двигателя
Проводка крышки багажника	Электрика
Проводка моторная	Электрика двигателя
Проводка моторчика стояночного тормоза	Электрика
Проводка мультимедиа	Электрика
Проводка навигации	Электрика
Проводка передней панели	Электрика
Проводка перемычка	Электрика
Проводка подкапотная	Электрика
Проводка потолка	Электрика
Проводка прикуривателя и разъёма aux	Электрика
Проводка редуктора	Электрика
Проводка рулевой колонки	Электрика
Проводка рулевой рейки	Электрика
Проводка руля	Электрика
Проводка с подрамника	Электрика
Проводка салона	Электрика
Проводка свечей накала	Электрика двигателя
Проводка стеклоподьёмника	Электрика
Проводка топливного бака	Электрика
Проводка форсунок	Электрика двигателя
Проводка центральной консоли	Электрика
Проекционный дисплей	Электрика
Прокладка	Двигатель и элементы
Прокладка впускного колектора	Двигатель и элементы
Прокладка клапанной крышки	Двигатель и элементы
Промежуточная пластина АКПП	Трансмиссия
Промежуточная шестерня заднего хода	Трансмиссия
Промежуточный вал	Трансмиссия
Промежуточный вал кпп	Трансмиссия
Проставка под пружину	Подвеска
Пружина багажника	Кузов и элементы
Пружина подвески	Подвеска
Пусковой топливный клапан	Топливная система
Пыльник	Кузов и элементы
Пыльник - отбойник амортизатора	Подвеска
Пыльник рулевой колонки	Рулевое управление
Пыльник рулевой рейки	Рулевое управление
Пыльник рулевой тяги	Рулевое управление
Пыльник тормозного диска	Тормозная система
Пыльник шруса	Трансмиссия
Рабочий тормозной цилиндр	Тормозная система
Рабочий цилиндр сцепления	Трансмиссия
Радиатор АКПП	Система охлаждения
Радиатор гидроусилителя	Система охлаждения
Радиатор ЕГР	Система охлаждения
Радиатор кондиционера	Отопление и кондиционирование
Радиатор масляный	Система охлаждения
Радиатор охлаждения	Система охлаждения
Радиатор охлаждения батареи	Система охлаждения
Радиатор охлаждения дополнительный	Система охлаждения
Радиатор охлаждения топлива	Система охлаждения
Радиатор печки	Отопление и кондиционирование
Радиоприемник Bavaria C Professional RDS	Электрика
Радиоприемник BMW Business RDS	Электрика
Раздаточная коробка	Трансмиссия
Разъем aux	Электрика
Разьём Type C	Электрика
Разьем USB	Электрика
Рамка АКПП	Салон
Рамка магнитофона	Салон
Рамка радиатора	Кузов и элементы
Распорка заднего подрамника	Подвеска
Распорка кузова	Кузов и элементы
Распорка переднего подрамника	Подвеска
Распорка передней панели	Кузов и элементы
Распредвал	Двигатель и элементы
Распредвал впускной	Двигатель и элементы
Распредвал выпускной	Двигатель и элементы
Распределитель B+, многоф.	Электрика
Распределитель масла	Двигатель и элементы
Распределитель тока	Электрика
Распределительный блок высокого напряжения	Электрика
Регулятор давления топлива	Топливная система
Регулятор давления тормозных усилий	Тормозная система
Регулятор дроссельной заслонки Ads 2	Электрика двигателя
Регулятор фаз газораспределения	Двигатель и элементы
Редуктор	Трансмиссия
резина	
Резина 255/60R18 KUMHO RoadVenture AT52	
Резина летняя 265/50 R19 KUMHO SOLUS 4S	
Резина на дисках	
Резистор вентилятора охлаждение	Электрика
Резистор дхо	Электрика / Блоки управления
Резистор печки	Отопление и кондиционирование
Резонатор воздушный	Впускная система
Резонатор глушителя	Выпускная система
Рейлинг на крышу	Кузов и элементы
Рейлинги на крышу	Кузов и элементы
Реле	Электрика
Реле дворников	Электрика
Реле свечей накала	Электрика 
Реле системы старт стоп	Электрика
Реле Стоп-Сигнала	Электрика
Реле топливного насоса	Электрика
Реле указателей поворотов	Электрика
Реле управления омывателем фар	Электрика
Реле центрального замка	Электрика
Ремень	Двигатель и элементы
Ремень безопасности	Airbag / Безопасность
Ремкомплект тормозного суппорта	Тормозная система
Ремкомплект цилиндра сцепления	Тормозная система
Реостат	Отопление и кондиционирование
Рессора	Подвеска
Решетка бампера	Кузов и элементы
Решетка капота	Кузов и элементы
Решетка обдува лобового стекла	Салон
Решетка радиатора	Наружные элементы кузова
Розетка	Электрика
Рокер клапана гбц	Двигатель и элементы
Ролик натяжной	Двигатель и элементы
Ролик обводной	Двигатель и элементы
Ролик раздвижной двери	Кузов и элементы
Рулевая колонка	Рулевое управление
Рулевая колонка с карданчиком	Рулевое управление
Рулевая колонка с ЭУР	Рулевое управление
Рулевая рейка	Рулевое управление
Рулевая сошка	Рулевое управление
Рулевая тяга	Рулевое управление
Рулевая тяга с наконечником	Рулевое управление
Рулевой карданчик	Рулевое управление
Рулевой наконечник	Рулевое управление
Рулевой редуктор	Рулевое управление
Руль	Салон
Ручка багажника	Кузов и элементы
Ручка бардачка	Салон
Ручка двери внешняя	Кузов и элементы
Ручка двери внутренняя	Салон
Ручка домкрата	Аксессуары
Ручка КПП	Салон
Ручка открывания капота	Салон
Ручка потолка	Салон
Ручка раздаточной коробки	Салон
Ручка регулировки рулевой колонки	Салон
Ручка регулировки сиденье	Салон
Ручка стеклоподъемника	Салон
Ручка стояночного тормоза	Тормозная система
Ручка центральной стойки	Салон
Рычаг подвески	Подвеска
Сабвуфер	Электрика
Сажевый фильтр	Выпускная система
Сайлентблоки подвески	Подвеска
Салфетка	Аксессуары
Сальник КПП	Трансмиссия
Светодиодный модуль	Оптика
Свеча накала	Электрика двигателя
Свечной наконечник	Электрика двигателя
Селектор АКПП	Трансмиссия
Сервопривод заслонки глушителя	Выпускная система
Сервопривод круиз-контроля	Тормозная система
Сетка в багажник	Салон
Сигнал	Электрика
Сигнализатор системы PDC	Электрика
Сигнализация	Электрика
Сиденье	Салон
Сирена сигнализации	Электрика
Скоба стабилизатора	Подвеска
Скоба суппорта	Тормозная система
Соединитель оптоволоконного кабеля	Электрика
Соленоид	Электрика
Соленоид топливного бака	Электрика
Солнцезащитная шторка	Салон
Спойлер	Кузов и элементы
Стабилизатор	Подвеска
Стабилизатор напряжения	Электрика / Блоки управления
Стаканчик регулировки клапанов	Двигатель и элементы
Стартер	Электрика
Стекло	Кузов и элементы
Стекло заднее	Стекла и зеркала
Стекло крышки багажника	Стекла и зеркала
Стекло люка	Кузов и элементы
Стекло панорамы	Кузов и элементы
Стекло противотуманной фары	Оптика
Стекло фары	Оптика
Стойка кузова центральная	Кузов и элементы
Стойка стабилизатора	Подвеска
Столик на спинку сиденья	Салон
Ступица	Подвеска
Ступица коленвала	Двигатель и элементы
Ступица масляного насоса	Трансмиссия
Ступица шестерни распредвала	Двигатель и элементы
Суппорт тормозной	Тормозная система
Тарелка пружины верхняя	Подвеска
Телевизор (передняя часть кузова)	Наружные элементы кузова
Телефон	Аксессуары
Теплообменник АКПП	Трансмиссия
Теплообменник масляного фильтра	Двигатель и элементы
Термовыключатель форсунок с обогревом	Электрика
Термозащита	Наружные элементы кузова
Термозащита переднего редуктора	Кузов и элементы
Термостат	Система охлаждения
Термостат акпп	Система охлаждения
ТНВД	Топливная система
Топливная рампа	Топливная система
Топливный бак	Топливная система
Топливный клапан	Топливная система
Топливный насос	Топливная система
Тормозная жидкость	Тормозная система
Тормозная трубка	Тормозная система
Тормозной барабан	Тормозная система
Тормозной диск	Тормозная система
Тормозные колодки	Тормозная система
Торпедо	Салон
Траверса	Трансмиссия
Трамблер	Электрика
Трапеция дворников	Кузов и элементы
Трос аварийной разблокировки АКПП	Трансмиссия
Трос замка двери	Кузов и элементы
Трос замка капота	Кузов и элементы
Трос замка крышки багажника	Кузов и элементы
Трос замка сиденья с ручкой	Салон
Трос заслонки печки	Отопление и кондиционирование
Трос капота с ручкой	Кузов и элементы
Трос лючка топливного бака	Кузов и элементы
Трос педали газа	Двигатель и элементы
Трос переключения передач	Трансмиссия
Трос спидометра	Трансмиссия
Трос стояночного тормоза	Тормозная система
Тросовый привод системы Interlock	Трансмиссия
трубка	Двигатель и элементы
Трубка EGR	Двигатель и элементы
Трубка АКПП	Трансмиссия
Трубка вакуумного насоса	Двигатель и элементы
Трубка вакуумного усилителя тормозов	Тормозная система
Трубка вентиляции	Двигатель и элементы
Трубка вентиляции картерных газов	Двигатель и элементы
Трубка вентиляции топливного бака	Топливная система
Трубка гидроподвески	Подвеска
Трубка гидроусилителя	Рулевое управление
Трубка датчика давления выхлопных газов	Двигатель и элементы
Трубка кондиционера	Отопление и кондиционирование
Трубка масляная	Двигатель и элементы
Трубка масляного радиатора	Трансмиссия
Трубка насоса вторичного воздуха	Двигатель и элементы
Трубка обратки топлива	Топливная система
Трубка охлаждение генератора	Система охлаждения
Трубка охлаждения акпп	Система охлаждения
Трубка охлаждения инвертора	Двигатель и элементы
Трубка охлаждения турбины	Впускная система
Трубка подачи масла в турбину	Двигатель и элементы
Трубка радиатора печки	Отопление и кондиционирование
Трубка рецеркуляции воздуха	Двигатель и элементы
Трубка с датчиком перепада давления выхлопных газов	Выпускная система
Трубка системы охлаждения	Система охлаждения
Трубка слива масла с турбины	Впускная система
Трубка сцепления	Трансмиссия
Трубка топливная	Топливная система
Трубка троса стояночного тормоза	Тормозная система
Трубка турбины	Впускная система
Турбина	Выпускная система
Тяга кулисы переключения передач	Трансмиссия
Угол бампера	Кузов и элементы
Указатель поворотов	Оптика
Ультразвуковой датчик сигнализации	Электрика
Уплотнитель	Кузов и элементы
Уплотнитель капота	Кузов и элементы
Уплотнитель крыла	Кузов и элементы
Уплотнитель люка	Кузов и элементы
Уплотнитель моторного отсека	Кузов и элементы
Уплотнитель порога	Кузов и элементы
Уплотнитель проема багажника	Кузов и элементы
Уплотнитель проема двери	Кузов и элементы
Уплотнитель радиатора	Кузов и элементы
Уплотнитель стекла	Кузов и элементы
Уплотнитель стекла двери	Кузов и элементы
Упор капота	Кузов и элементы
Упор противооткатный	Аксессуары
Усилитель антенны	Электрика
Усилитель бампера	Наружные элементы кузова
Усилитель двери	Кузов и элементы
Усилитель звука	Электрика
Успокоитель цепи Акпп	Трансмиссия
Успокоитель цепи ГРМ	Двигатель и элементы
Фара	Оптика
Фара противотуманная	Оптика
Фаркоп	Кузов и элементы
Фиксатор	Салон
Фильтр абсорбера	Топливная система
Фильтр АКПП	Трансмиссия
Фильтр воздушный	Впускная система
Фильтр маслянный	Двигатель и элементы
Фильтр салона	Салон
Фильтр топливный	Топливная система
Фишка	Электрика
Фланец	Система охлаждения
Фланец впускного колектора	Впускная система
Фланец дроссельной заслонки	Электрика двигателя
Фланец патрубка интеркулера	Впускная система
Фланец радиатора EGR	Двигатель и элементы
Фланец системы охлаждения	Система охлаждения
Фланец топливного насоса	Топливная система
Фланец турбины	Кронштейны двигателя
Фонарь бампера	Оптика
Фонарь заднего хода	Оптика
Форсунка омывателя	Кузов и элементы
Форсунка омывателя фар	Кузов и элементы
Форсунка топливная	Топливная система
Форточка двери	Кузов и элементы
Форточка кузова	Стекла и зеркала
Футляр для очков	Салон
Хомут глушителя	Выпускная система
Хром накладка решётки	Кузов и элементы
Цапфа подвески	Подвеска
Центральная консоль	Салон
Центральный дефлектор салона	Салон
Центральный динамик в торпеду	Электрика
Центральный клапан Vanos	Двигатель и элементы
Цепь Акпп	Трансмиссия
Часы	Электрика
Четверть кузова	Кузов и элементы
Чехол запасного колеса	Кузов и элементы
Чехол ручки КПП	Салон
Чехол ручки стояночного тормоза	Салон
Шаровая опора	Подвеска
Шатун	Двигатель и элементы
Шестерня Акпп	Трансмиссия
Шестерня балансирного вала	Двигатель и элементы
Шестерня впускного распредвала	Двигатель и элементы
Шестерня выпускного распредвала	Двигатель и элементы
Шестерня коленвала	Двигатель и элементы
Шестерня масляного насоса	Двигатель и элементы
Шестерня распредвала	Двигатель и элементы
Шестерня тнвд	Топливная система
Шина всесезонная	
Шина всесезонная 225/50 R17 Goodyear Reliant	
Шина всесезонная 225/50 R19 Uniroyal Tiger Paw A/S 107V	
Шина всесезонная 235/60 R17 Hifly Vigorous HT601	
Шина всесезонная 245/40 R18 Pirelli Cinturato P7 97H	
Шина всесезонная 245/40 R18 Uniroyal Tiger Paw Touring a/s	
Шина всесезонная 255/35 R19 Continental ExtremeContact dws06	
Шина всесезонная 255/35 R19 Michelin Pilot Sport a/s 3+	
Шина всесезонная 265/40 R20 Pirelli PZero Nero All Season	
Шина всесезонная 285/45 R20 Goodyear Eagle Sport	
Шина зимняя	
Шина зимняя 185/65 R15 Michelin Alpin	
Шина зимняя 205/50 R17 LingLong Green-Max Winter Ice I-15	
Шина летняя	
Шина летняя 205/55 R16 Michelin Energy Saver A/S	
Шина летняя 215/55 R17 Michelin Primacy MXV4	
Шина летняя 215/55 R17 Yokohama Avid Ascend	
Шина летняя 225/50 R17 Continental ProContact TX	
Шина летняя 235/45 R18 Arrowspeed Performance UHP	
Шина летняя 235/45 R18 Michelin Pilot Sport 4	
Шина летняя 235/60 R17 Saferich FRC26 outside	
Шина летняя 245/40 R18 Ironman iMove Gen3 as	
Шина летняя 245/40 R18 Ironman Imove Gen3 As 97W	
Шина летняя 245/40 R18 Sailun Atrezzo SVA1	
Шина летняя 245/40 ZR18 Nexen Nfera SU1 97Y	
Шина летняя 245/45 R17 General Exclaim UHP	
Шина летняя 245/45 R18 Bridgestone Turanza ER300	
Шина летняя 245/45 R18 Goodyear Eagle LS2	
Шина летняя 245/45 R18 Hankook Kinergy PT	
Шина летняя 245/50 R20 Sailun Terramax Hlt 102H	
Шина летняя 255/35 R19 Hankook Ventus V12 Evo 2	
Шина летняя 255/40 R19 Continental Supercontact RX	
Шина летняя 255/40 R19 Sumitomo HTR Enhance WX2	
Шина летняя 255/50 R19 Hankook Ventus S1 Evo2 SUV	
Шина летняя 255/55 R18 Michelin Latitude Tour HP	
Шина летняя 265/40 R20 Accelera Iota ST68	
Шина летняя 265/45 R20 Continental ContiCrossContact LX Sport	
Шина летняя 265/50 R19 Bridgestone Dueler H/L 400	
Шина летняя 265/50 R19 Delinte Desert Storm2 DS8	
Шина летняя 265/50 R19 Michelin Latitude Tour HP	
Шина летняя 275/30 R24 Atlas Force UHP	
Шина летняя 275/30 R24 Lexlini LX-Thirty	
Шина летняя 275/40 R20 Pace Impero 106W	
Шина летняя 275/40 R20 Pirelli P Zero 106W	
Шина летняя 275/45 R20 Kumho Ecsta STX 106W	
Шина летняя 275/50 R20 Continental CrossContact LX Sport 113H	
Шина летняя 315/35 R20 Pace Impero 110W	
Шины всесезонные	
Шины всесезонные 205/60 R16Toyo proxes a37	
Шины всесезонные 225/50 R17 Goodyear Reliant	
Шины всесезонные 225/60 R18 General Graber AT3	
Шины всесезонные 235/55 R20 Michelin Premier LTX	
Шины всесезонные 235/60 R18 Michelin Premier LTX	
Шины всесезонные 235/60 R18 Milestar MS932 Sport	
Шины всесезонные 245/45 R18 Goodyear Eagle Sport	
Шины всесезонные 245/45 R19 Goodyear Eagle Sport LS2	
Шины всесезонные 245/70 R17 Bridgestone Dueler A/T Revo 3	
Шины всесезонные 255/55 R19 General Grabber AT3	
Шины всесезонные 255/60 R18 Kumho Roadventure AT52	
Шины всесезонные 265/50 R19 Kumho Solus 4S	
Шины всесезонные 265/50 R19 Toyo Celsius Cuv	
Шины всесезонные 285/45 R20 Continental Crosscontact LX Sport	
Шины всесезонные 285/45 R20 Goodyear Eagle Sport	
Шины всесезонные 285/45 r20 Pirelli Scorpion Verde	
Шины всесезонные 295/45 R20 Pirelli Scorpion Verde	
Шины всесезонные Zenna Sport line 235/55 R17	
Шины зимние	
Шины зимние 205/50 R17 FEDERAL Himalaya WS2	
Шины зимние 205/50 R17 LingLong Green-Max Winter Ice I-15	
Шины зимние 215/65 R17 Bridgestone Blizzak LM-001	
Шины зимние 215/70 R16 Goodride SW658 100T	
Шины зимние 225/50R17 Bridgestone Blizzak LM001	
Шины зимние 225/60 R18 Bridgestone Blizzak LM-001	
Шины зимние 245/50 R18 Pirelli Sottozero	
Шины зимние 285/50 R20 Bridgestone Blizzak DM-V2	
Шины летние	
Шины летние 195R15C Zeta ZTR 08 106/104s	
Шины летние 205/55 R16 Kumho Solus TA11	
Шины летние 215/55 R17 Michelin Defender T+H	
Шины летние 225/45 R17 Continental ContiProContact SSR	
Шины летние 225/45 R17 Pirelli PZero Rosso	
Шины летние 225/50 R17 Bridgestone Turanza El 400	
Шины летние 225/50 R17 Continental ProContact TX	
Шины летние 225/50 R17 Sailwin Sportway 56	
Шины летние 225/55 R18 Falken Ziex ZE001 A/S	
Шины летние 225/55R17 GoodYear Eagle F1	
Шины летние 225/65 R17 Dunlop Grandtrek ST30	
Шины летние 225/65 R17 Yokohama Geolandar G91	
Шины летние 235/55 R19 Cooper Discoverer HTS	
Шины летние 235/55 R19 Hankook Dynapro HP2	
Шины летние 235/60 R17 Saferich FRC26	
Шины летние 245/40 R18 Ironman Imove Gen3 As 97W	
Шины летние 245/40 R18 Sailun Atrezzo SVA1	
Шины летние 245/40 R19 Sumitomo HTR Enhance WX2	
Шины летние 245/40 ZR18 Champiro UHP AS 97Y	
Шины летние 245/40R18 Goodyear Eagle Sport 93W	
Шины летние 245/45 R18 Bridgestone Potenza RE050A	
Шины летние 245/45 R18 Goodyear Eagle F1 Asymmetric 3	
Шины летние 245/45 R18 Ironman Imove Gen3 AS	
Шины летние 245/45 R18 Nexen Nfera AU7	
Шины летние 245/45 R19 Goodyear Eagle Sport LS2	
Шины летние 245/50 Hankook Ventus S1 noble 2 ZR1 100W	
Шины летние 245/50 R18 Atlas Force UHP 100Y	
Шины летние 245/50 R18 Hankook Ventus S1 noble 2 ZR1 100W	
Шины летние 245/55 R17 Bridgestone Dueler H/L 400	
Шины летние 255/35 R19 Bridgestone Potenza S001 96Y	
Шины летние 255/50R19 Nokian Zline A/S SUV 107W	
Шины летние 255/55 R18 Goodyear Eagle Ls2	
Шины летние 255/55 R18 Michelin Primacy Tour A/S	
Шины летние 255/55 R18 Pirelli Scorpion Verde	
Шины летние 255/60 R18 Kumho Crugen Premium	
Шины летние 255/70 R18 Bridgestone Dueler H/T	
Шины летние 265/50 R19 Kumho Solus 4S	
Шины летние 265/50 R19 Michelin Latitude Tour HP	
Шины летние 265/50 R19 Michelin Latitude Tour HP 110V	
Шины летние 265/50 R19 NEXEN NFera RU1	
Шины летние 265/50 R19 Nitto NT421Q	
Шины летние 265/50 R20 Cooper Endeavor Plus 111T	
Шины летние 265/60 R18 Dextero DHT2	
Шины летние 275/30 R24 Lexlini LX-Thirty	
Шины летние 275/40 R20 Royal Black Royal Pertormance	
Шины летние 275/45 R20 Kumho Ecsta STX 106W	
Шины летние 275/45 R20 Sailun Atrezzo Svr Lx+	
Шины летние 275/50 R20 Continental CrossContact LX25 109H	
Шины летние 285/40 R21 Pirelli Scorpion Verde	
Шкив коленвала	Двигатель и элементы
Шкив насоса гидроусилителя	Рулевое управление
Шкив помпы	Система охлаждения
Шланг VANOS	Двигатель и элементы
Шланг вентиляции	Двигатель и элементы
Шланг гидроусилителя	Рулевое управление
Шланг омывателя фар	Кузов и элементы
Шланг топливный	Топливная система
Шланг тормозной	Тормозная система
Шторка багажника	Салон
Шторка панорамной крыши	Салон
Шумоизоляция двигателя	Кузов и элементы
Шумоизоляция капота	Кузов и элементы
Щетка стеклоочистителя	Кузов и элементы
Щиток моторного отсека	Кузов и элементы
ЭБУ	Электрика / Блоки управления
ЭБУ Active Sound Design	Электрика / Блоки управления
Эбу JBE 2	Электрика / Блоки управления
ЭБУ JBE 3	Электрика / Блоки управления
ЭБУ освещения поворотов с крышкой	Электрика / Блоки управления
ЭБУ системы AUC	Электрика / Блоки управления
ЭБУ системы Dwa незакодированный	Электрика / Блоки управления
Эжекционный насос	Топливная система
Эксцентриковый вал	Двигатель и элементы
Эластичная муфта	Трансмиссия
Электровакуумный насос тормозной системы	Тормозная система
Электроусилитель руля	Рулевое управление
Эмблема	Кузов и элементы
Ящик для инструментов	Аксессуары
Ящик центральной консоли	Салон